0000000000000000000000000000000000000000000000
0000000000000000000000000000000000000000000000
0000000000000000000000000000000000000000000000
0000000000000000000000000000000000000000000000
0000000000000000000000000000000000000000000000
0000000000000000000000000000000000000000000000
0000000000000000000000000000000000000000000000
0000000000000000000000000000000000000000000000
0000000000000000000000000000000000000000000000
0000000000000000000000000000000000000000000000
0000000000000000000000000000000000000000000000
0000000000000000000000000000011110000000000000
0000000000000000000000000000010000000000000000
0000000000000000000000000000010000000000000000
0000000000000000000000000000010000000000000000
0000000000000000133333333333110000000000000000
0000000000000000111111111111100000000000000000
0000000000000000100000000000000000000000000000
0000000000000000100000000000141000000000000000
1111550000000111100000000000111000000000000000
0000000000000000000000000000000000000000000000