000000000000000000000000000000000000000000000000000000000000000000000000000000
000000000000000000000000000000000000000000000000000000000000000000000000000000
000000000000000000000000000000000000000000000000000000000000000000000000000000
000000000000000000000000000000000000000000000000000000000000000000000000000000
000000000000000000000000000000000000000000000000000000000000000000000000000000
000000000000000000000000000000000000000000000000000000000000000000000000000000
000000000000000000000000000000000000000000000000000000000000000000000000000000
000000000000000000000000000000000000000000000000000000000000000000000000000000
000000000000000003313300000000000000000000000000000000000000000000000000000000
000000001111111330003333333331000000000000000000000000000000000000000010000000
000000001000000000003333333333333313333312222200000000000000000000000010000000
000000001000000000000000000000000000000000000000000000000000000000000010000000
000000001000000000000000000000000000000000000000000000000000000000000010000000
111155551000000000000000000000000000000000000000000000000000000000000010000000
000111111000000000000000000000000000000000000500000000000000000000000010000000
000000000000000000000000000000000000000000000000000000555555555555500010000000
000000000000000000000000000000000000000000000000000000111111111111100010000000
000000000000000000000000000000000000000010000000001000000000000000100010000000
000000000000000000000000000000000000000000000000000000000000000000100010000000
000000000000000000000000001000000000000000000000000000000000000000100010000000
000000000000000000000000000000001000000000000000000000000000000000100010000000
000000000000000000000000000000000000000000000000000000000000000000100010000000
000000000000000000000000000000000000000000000000000000000000000000100010000000
000000000000000000000000000000000000000000000000000000000000000000100010000000
000000000000000000000000000000000000000000000000000000000000000000100010000000
000000000000014100000000000000000000000000000000000000000000000000100010000000
000000000000011100000000000000000000000000000000000000000000000000100010000000
000000000000000000000000000000000000000000000000000000000000000000100010000000
000000000000000000000000000000000000000000000000000000000000000000100010000000
000000000000000000000000000000000000000000000000000000000000000000100010000000
000000000000000000000000000000000000000000000000000000000000000000100010000000
000000000000000000000000000000000000000000000000000000000000000000133310000000
000000000000000000000000000000000000000000000000000000000000000000133310000000
000000000000000000000000000000000000000000000000000000000000000000133310000000
000000000000000000000000000000000000000000000000000000000000000000111110000000
000000000000000000000000000000000000000000000000000000000000000000000000000000