11111111111111111111111111111111111111111111111111111110000111111111111111111111111111111111111111111111111111
11111111111111111000001111111111111111000001111111111110000111111111111111111111111111111111111111111111111111
11111111111100000000000000000000000000000000000000001110000111111111111111111111111111111111111111111111111111
11111111111111111110111111111111111111110111111111101110000111111111000001111111111110000011111111110000011111
11111111111111111110111111111111111111110111111111100000000000000000000000000000000000000000000000000000001111
11111111111111111110111111111111111111110111111111111111155551111111110111111111111111101111111111111101111111
11111111111111111110111111111111111111110111111111111111111111111111110111111111111111101111111111111101111111
11111111111111111110111111111111110000000000111111111111111111111111110111111111111111101111111111111101111111
11111111111111111110111111111111110111110110111111111111111111111111110111111111111111101111111111111101111111
11111111111111111110111111111111110111110110111111111111111111111111110111111111111111101111111111111101111111
11111111100000000000000000111111110111110110111111111111111111111111110111111111111111101111111111111101111111
11111111101111111111111110111111110111110110111111111111111111111111110111111111111111101111111111111101111111
11111111101111111111111110111111110111110110111111111111111111111111110111111111000000000000000000111101111111
11111111101111111111111110111111110111110110111111111111111111111111110111111111011111111111111110111101111111
11111111101111111111111110111111112111110112111111111111111111111111110111111111011111111111111110111101111111
11111111101111111111111110111111111111110111111111111111111111111111110111111111011111111111111110111101111111
11111111101111111111111110111111111111110111111111111111111111111111110111111111011111111111111110111100000111
11100000001111111111111110111111111111110111111111111111111111111111113111111111011111111111111110111111110111
11133555551111111111111110111111111111110111111111111111111111111111111111111111011111111111111110111111110111
11111111111111111111111110111111111111110111111111111111111111111111111111111111011111111111111110111111110111
11111111111111111111111110111111111111110111111111111111111111111111111111111111011111111111111110111111110111
11111111111111111111111110111111111111113111111111111111111111111111111111111111011111111111111110111111110111
11111111111111111111111110111111111111111111111111111111111111100000001111111111011111111111111110111111110111
11111111111111111111111110111111111111111111111000000001111110000000000000000000000000011111111110111111110111
11111111111111111111111110111111111111111111111000000001111110000000111111111111111411111111111110111111110111
11111111111111111111111110111111111111111111100000000001111110000000111111111111111111111111111110111111110111
11111111111111111111111110111111111111111110000000000000000000000555111111111111111111111111111110111111110111
11111111111111111111111110111111111111110000000013333111111111000111111111111111111111111111111111111111110111
11111111111111111111111110111111111111110000111113333111111111000111111111111111111111111111111111111111110111
11111111111111111111111110111111111111110011111111111111111111000111111111111111111111111111111111111111110111
11111111111111111111111110000000000000000011111111111111111111000111111111111111111111111111111111111111110111
11111111111111111111111111111111111111111111111111111111111111000111111111111111111111111111111111111111110111
11111111111111111111111111111111111111111111111111111111111111000111111111111111111111111111111111111111110111
11111111111111111111111111111111111111111111111111111111111111000111111111111111111111111111111111111111110111
11111111111111111111111111111111111111111111111111111111111111000111111111111111111111111111111111111111110111
11111111111111111111111111111111111111111111111111111111111111000111111111111111111111111111111111111111110111